waji = nasa
toaha = sona
vers = understand
modene = new
folel = love
hao = good
ito = ni/ona
sha = mi
du = sina
mal- = opposite
ta = negation
ala = no
evet = yes
diras = speak
sarid = hear
tai... le = la
lingo = language
pijin = pidgin
kalezzo = colors
sek = bad
hito = big
zha = lon
ᏨᏉᏬ = original
hasi = or
epse = also
heto = many
omedeto = great excitement
qwishtca = alasa
pasimdeasiodj = invisible

ᏩᏪ!
ᏗᎳᏍ Ꮜ ᎢᏍ... ᎹᎳᎭᎣ ᎮᏙ